15
15
0,0,0,1,0,0,2,0,2,0,0,1,0,0,0
0,0,0,0,0,0,0,2,0,0,0,0,0,0,0
1,0,1,1,0,0,0,2,0,0,2,0,1,0,1
0,0,0,0,0,0,0,0,0,0,0,0,0,0,0
0,0,0,0,2,0,2,3,0,0,0,0,0,0,0
0,0,2,0,0,0,2,0,2,0,0,0,0,0,0
0,0,0,0,0,2,0,2,0,2,3,0,0,0,0
0,0,0,2,0,2,0,0,0,2,2,0,0,0,0
0,0,0,0,0,2,2,0,0,2,0,3,0,0,0
0,0,0,0,0,0,0,2,0,2,2,0,0,0,0
0,0,0,0,0,0,0,0,0,0,0,3,0,0,0
0,0,0,0,2,3,2,0,2,0,0,0,0,0,0
0,1,0,0,1,0,0,0,0,0,0,0,1,0,0
0,0,0,1,0,0,0,3,0,0,0,1,0,0,0
0,0,0,1,0,0,3,0,3,0,1,0,0,0,0
*
0.5,0.5,0
7.5,0.5,0
14.5,0.5,0
0.5,14.5,180
7.5,14.5,180
14.5,14.5,180
*
13.5,7.5
*
